5
40.0
6 0 0 0
18 19
0;0;0;0;0;0;0;0;12;14;0;0;0;0;0;0;0;0
0;0;0;0;0;5;1;1;12;14;1;1;1;0;0;0;0;0
0;0;0;0;0;1;1;1;12;14;1;6;1;0;0;0;0;0
0;0;0;0;0;1;1;1;12;14;1;1;1;0;0;0;0;0
0;0;0;0;0;1;7;8;12;14;8;1;1;0;0;0;0;0
0;0;0;0;1;1;1;1;12;14;1;1;2;1;0;0;0;0
0;1;1;1;1;1;1;1;12;14;1;1;1;1;1;1;5;0
0;1;1;4;1;7;8;1;12;14;7;8;1;1;1;1;1;0
0;1;1;9;10;10;10;10;18;19;10;10;10;10;11;1;1;0
0;0;0;12;14;0;0;0;0;0;0;0;0;20;14;0;0;0
0;0;0;12;14;0;0;0;0;0;0;0;0;12;14;0;0;0
0;1;1;12;14;1;1;1;2;1;1;1;1;12;14;1;6;0
0;1;1;12;19;10;10;10;10;10;10;10;10;18;14;5;1;0
0;2;1;15;16;16;16;16;20;21;16;16;16;16;17;1;1;0
0;0;0;0;1;1;1;5;12;14;1;1;1;1;0;0;0;0
0;0;0;0;1;1;1;1;12;14;1;1;1;1;0;0;0;0
0;0;0;0;1;7;8;6;15;17;7;8;1;1;0;0;0;0
0;0;0;0;1;1;1;1;1;1;1;1;4;1;0;0;0;0
0;0;0;0;0;0;0;0;0;0;0;0;0;0;0;0;0;0

53;53;53;53;59;1;11;1;75;75;1;11;1;61;53;53;53;53
53;53;53;53;60;9;12;2;75;75;9;12;2;62;53;53;53;53
53;53;53;53;64;0;0;0;0;0;0;0;0;63;53;53;53;53
53;53;53;53;64;0;0;25;0;0;25;0;0;63;53;53;53;53
59;1;11;1;39;0;0;26;0;0;26;0;0;37;1;11;1;61
60;9;12;2;40;0;0;0;0;0;0;0;0;38;9;12;2;62
64;0;0;0;0;0;25;0;0;0;0;25;0;0;0;0;0;63
64;0;0;0;0;0;26;0;0;0;0;26;0;0;0;0;0;63
64;0;0;0;0;0;0;0;0;0;0;0;0;0;0;0;0;63
43;7;13;17;19;1;11;3;5;5;7;11;13;17;19;1;3;44
60;8;14;18;20;9;12;4;6;6;10;12;14;18;20;2;4;62
64;0;0;0;0;0;0;0;0;0;0;0;0;0;0;0;0;63
64;0;0;0;0;0;0;0;0;0;0;0;0;0;0;0;0;63
64;0;0;0;0;0;0;0;0;0;0;0;0;0;0;0;0;63
65;54;54;54;56;0;0;0;0;0;0;0;0;55;54;54;54;67
53;53;53;53;58;0;25;0;0;0;0;25;0;57;53;53;53;53
53;53;53;53;58;0;26;0;0;0;0;26;0;57;53;53;53;53
53;53;53;53;58;0;0;0;0;0;0;0;0;57;53;53;53;53
53;53;53;53;65;54;54;54;54;54;54;54;54;67;53;53;53;53
