6
40.0
9 0 0 0
21 19
0;0;0;0;0;0;0;0;0;0;0;0;0;0;0;0;0;0;0;0;0
0;0;0;0;0;0;0;0;0;0;0;0;0;0;0;0;0;0;0;0;0
0;0;0;0;0;0;0;0;0;0;1;1;1;1;1;1;1;1;1;1;0
0;0;0;0;0;0;0;0;0;0;1;1;1;1;1;1;1;1;1;1;0
0;0;0;0;0;0;0;0;0;0;1;7;8;1;1;1;0;0;1;1;0
0;9;10;10;11;0;0;0;0;0;1;1;1;1;1;1;0;0;1;1;0
0;12;22;13;14;0;0;0;0;0;0;0;0;0;0;0;0;0;9;11;0
0;12;13;23;14;1;0;0;0;0;0;0;0;0;0;0;0;0;12;14;0
0;15;16;16;17;1;1;1;0;0;0;0;0;0;0;0;0;0;12;14;0
0;0;0;0;0;0;1;1;0;0;0;0;25;25;25;26;0;0;12;14;0
0;0;0;0;0;0;1;1;0;0;0;0;25;26;25;25;0;0;12;14;1
0;0;0;0;0;0;1;1;1;0;0;0;0;25;25;0;0;0;12;14;1
0;0;0;0;0;1;1;1;1;1;1;0;0;25;26;0;0;0;12;14;0
0;0;0;0;0;1;1;1;1;1;1;1;1;1;1;1;0;0;12;14;0
0;0;0;0;0;1;1;1;1;1;1;1;1;1;1;1;1;1;12;14;0
0;0;0;0;0;1;7;8;1;1;1;1;1;1;1;1;1;1;12;14;0
0;0;0;0;0;1;1;1;1;1;1;1;1;7;8;1;1;1;15;17;0
0;0;0;0;0;0;0;0;0;0;0;1;1;1;1;1;1;1;0;0;0
0;0;0;0;0;0;0;0;0;0;0;0;0;0;0;0;0;0;0;0;0

53;53;53;53;53;53;53;53;53;59;1;1;11;1;1;11;1;1;11;1;61
53;53;53;53;53;53;53;53;53;60;2;9;12;2;9;12;2;9;12;2;62
53;53;53;53;53;53;53;53;53;64;0;0;0;0;0;0;0;0;0;0;63
59;1;75;75;1;61;53;53;53;64;0;0;25;0;0;0;0;0;0;0;63
60;2;75;75;2;62;53;53;53;64;0;0;26;0;0;55;54;69;17;19;44
64;0;0;0;0;63;53;53;53;64;0;0;0;0;0;57;53;60;18;20;62
64;0;0;0;0;37;1;1;61;65;54;54;54;54;54;67;53;64;0;0;63
64;0;0;0;0;38;2;2;62;53;53;59;1;1;1;1;61;64;0;0;63
64;0;0;0;0;0;0;0;63;53;53;60;2;2;2;2;62;64;0;0;63
65;54;54;54;54;69;17;19;44;53;53;64;0;0;0;0;63;64;0;0;63
53;53;53;53;53;60;18;20;41;1;61;64;0;0;0;0;63;64;0;0;63
53;53;53;53;59;39;0;0;38;2;41;52;13;17;19;71;67;64;0;0;63
53;53;53;53;60;40;0;0;0;0;38;2;14;18;20;41;61;64;0;0;63
53;53;53;53;64;0;0;0;0;0;0;0;0;0;0;38;41;39;0;0;63
53;53;53;53;64;0;0;25;0;0;0;0;0;0;0;0;38;40;0;0;63
53;53;53;53;64;0;0;26;0;0;55;56;0;0;25;0;0;0;0;0;63
53;53;53;53;64;0;0;0;0;0;57;58;0;0;26;0;0;0;0;0;63
53;53;53;53;65;54;54;54;54;54;67;58;0;0;0;0;0;55;54;54;67
53;53;53;53;53;53;53;53;53;53;53;65;54;54;54;54;54;67;53;53;53