8
40.0
10 2 0 0
29 21
0;0;0;0;0;0;0;0;0;0;0;0;0;0;0;0;0;0;0;0;0;0;0;0;0;0;0;0;0
0;0;0;0;0;0;0;0;0;0;0;0;0;0;0;0;0;0;0;0;0;0;0;0;0;0;0;0;0
0;0;0;0;0;0;0;26;25;25;25;0;0;0;0;0;0;0;0;25;26;26;25;25;0;0;0;0;0
0;0;0;0;0;0;0;25;26;25;26;25;25;25;0;0;0;0;0;25;25;26;26;25;0;0;0;0;0
0;0;0;0;0;0;0;0;0;0;0;0;25;25;0;0;0;0;0;0;25;25;25;26;0;0;0;0;0
0;0;0;0;0;0;0;0;0;0;0;0;26;25;0;0;0;0;0;0;0;25;26;25;0;0;0;0;0
0;0;0;0;0;0;0;0;0;0;0;0;25;26;0;0;0;0;0;0;0;25;25;25;0;0;0;0;0
0;25;26;25;25;25;25;0;0;0;0;0;25;25;25;0;0;25;26;25;0;25;25;25;0;0;0;0;0
0;25;25;25;25;25;25;25;0;0;0;25;25;25;25;0;0;25;25;25;25;25;26;25;25;26;26;25;0
0;25;25;25;26;25;25;26;25;25;25;26;25;26;25;25;25;25;25;0;25;25;25;0;0;25;25;25;0
0;26;25;25;25;25;26;25;0;0;0;25;25;25;26;25;25;26;25;0;25;25;25;0;0;25;25;26;0
0;25;25;26;25;25;25;25;0;0;0;0;0;0;0;25;25;25;0;0;25;25;25;0;0;25;25;26;0
0;0;0;0;0;25;25;25;0;0;0;0;0;0;0;25;25;25;0;25;26;25;26;25;25;25;26;25;0
0;0;0;0;0;25;25;25;0;0;0;0;0;0;0;25;26;25;0;25;25;26;25;25;25;26;25;25;0
0;0;0;0;0;25;25;25;0;0;0;0;0;0;0;25;25;25;0;0;0;0;0;0;0;0;0;0;0
0;0;0;0;0;25;26;25;25;25;25;25;0;0;0;26;25;25;0;0;0;0;0;0;0;0;0;0;0
0;0;0;0;0;25;25;0;0;25;25;25;26;25;25;25;26;25;0;0;0;0;0;0;0;0;0;0;0
0;0;0;0;0;26;25;0;0;25;26;25;0;0;0;0;0;0;0;0;0;0;0;0;0;0;0;0;0
0;0;0;0;0;25;25;0;0;25;25;25;0;0;0;0;0;0;0;0;0;0;0;0;0;0;0;0;0
0;0;0;0;0;26;25;25;25;25;25;26;0;0;0;0;0;0;0;0;0;0;0;0;0;0;0;0;0
0;0;0;0;0;0;0;0;0;0;0;0;0;0;0;0;0;0;0;0;0;0;0;0;0;0;0;0;0

53;53;53;53;53;53;59;1;1;1;61;53;53;53;53;53;53;53;59;1;1;1;1;1;61;53;53;53;53
53;53;53;53;53;53;60;2;2;2;41;1;1;1;61;53;53;53;60;2;2;2;2;2;62;53;53;53;53
53;53;53;53;53;53;64;0;0;0;38;2;2;2;62;53;53;53;64;0;0;0;25;0;63;53;53;53;53
53;53;53;53;53;53;64;0;0;0;0;0;0;0;63;53;53;53;64;0;0;0;26;0;63;53;53;53;53
53;53;53;53;53;53;65;54;54;54;54;54;56;0;63;53;53;53;65;54;56;0;0;0;63;53;53;53;53
59;1;13;75;75;1;1;61;53;53;53;53;58;0;63;53;59;1;1;29;65;56;0;55;67;53;53;53;53
60;2;14;75;75;2;2;62;53;53;53;59;35;0;37;61;60;2;2;41;1;35;0;33;1;1;1;1;61
64;0;0;0;0;0;0;37;1;1;1;42;36;0;38;62;64;0;0;38;2;36;0;34;2;2;2;2;62
64;0;0;55;56;0;0;38;2;2;2;40;0;25;0;37;39;0;0;0;0;0;0;0;0;0;0;0;63
64;0;0;33;35;0;0;0;0;0;0;0;0;26;0;38;40;0;55;54;56;0;55;54;54;56;0;0;63
64;0;0;34;36;0;0;55;54;54;54;56;0;0;0;0;0;0;57;59;35;0;33;61;59;35;0;0;63
64;0;0;0;0;0;0;57;53;53;53;65;54;54;54;56;0;55;67;60;36;0;34;62;60;36;0;0;63
65;54;54;54;54;56;0;57;53;53;53;53;53;53;53;58;0;57;53;58;0;0;0;57;58;0;0;0;63
53;53;53;53;59;35;0;33;1;1;1;61;53;53;53;58;0;57;53;58;0;0;0;57;58;0;0;0;63
53;53;53;53;60;36;0;34;2;2;2;41;1;1;1;35;0;57;53;65;54;54;54;67;65;54;54;54;67
53;53;53;53;64;0;0;0;0;0;0;38;2;2;2;36;0;57;53;53;53;53;53;53;53;53;53;53;53
53;53;53;53;64;0;55;54;54;56;0;0;0;0;0;0;0;57;53;53;53;53;53;53;53;53;53;53;53
53;53;53;53;64;0;33;1;1;35;0;55;54;54;54;54;54;67;53;53;53;53;53;53;53;53;53;53;53
53;53;53;53;64;0;34;2;2;36;0;57;53;53;53;53;53;53;53;53;53;53;53;53;53;53;53;53;53
53;53;53;53;64;0;0;0;0;0;0;57;53;53;53;53;53;53;53;53;53;53;53;53;53;53;53;53;53
53;53;53;53;65;54;54;54;54;54;54;67;53;53;53;53;53;53;53;53;53;53;53;53;53;53;53;53;53
