14
80.0
13 4 6 4
40 40
0;0;0;0;0;0;0;0;0;0;0;0;0;0;0;0;0;0;0;0;0;0;0;0;0;0;0;0;0;0;0;0;0;0;0;0;0;0;0;0
0;0;0;0;0;0;0;0;0;0;0;0;0;0;0;0;0;0;0;0;0;0;0;0;0;0;0;0;0;0;0;0;0;13;13;0;0;0;0;0
0;0;0;25;1;1;1;1;0;0;0;0;0;0;0;0;0;0;0;0;0;0;0;0;0;0;0;0;0;0;0;0;0;13;13;0;0;0;0;0
0;0;25;25;25;26;25;25;25;0;0;0;1;1;1;1;1;1;0;0;0;0;0;0;0;0;0;1;1;1;1;1;15;16;16;17;1;1;1;0
0;0;25;25;25;25;25;26;26;0;0;0;1;9;10;10;11;1;0;0;0;0;0;0;0;0;1;1;1;1;0;1;5;1;1;1;1;1;1;0
0;0;25;25;26;25;25;25;25;0;0;0;1;15;16;16;17;1;0;0;0;0;1;1;1;4;1;1;1;1;0;0;0;0;0;0;1;1;0;0
0;0;25;25;25;25;26;25;25;0;0;0;1;1;1;1;1;1;0;0;0;0;1;1;9;10;11;1;4;1;0;0;0;0;0;0;1;1;0;0
0;0;0;0;0;25;25;0;0;0;0;0;7;8;1;7;8;1;0;0;0;0;7;8;12;22;14;8;1;1;0;0;0;0;0;25;25;26;25;0
0;0;0;0;0;25;25;0;0;0;0;1;1;1;1;1;1;1;1;0;0;0;1;1;12;13;14;1;1;1;0;0;0;0;0;25;25;25;25;0
0;1;1;1;9;10;10;10;10;10;10;10;10;10;10;10;10;10;11;1;0;0;1;9;18;24;19;10;10;10;10;11;1;0;0;25;25;25;26;0
0;7;8;1;15;16;16;16;16;16;16;20;21;16;16;16;20;21;17;1;0;0;1;15;16;16;16;16;16;16;16;17;1;0;0;26;25;25;25;0
0;1;1;1;1;1;1;6;1;1;1;12;14;1;1;1;12;14;1;0;0;0;0;0;1;1;0;0;0;0;1;1;1;0;0;0;0;0;0;0
0;0;0;1;1;0;1;1;1;1;0;12;14;0;0;0;12;14;0;0;0;0;0;0;1;1;1;1;0;0;1;1;1;0;0;0;0;0;0;0
0;0;0;1;1;0;0;0;0;0;0;12;14;0;0;0;12;14;1;1;1;1;1;1;1;1;1;1;0;0;1;1;1;0;0;0;0;0;0;0
0;0;0;25;26;0;0;0;0;0;0;12;14;0;0;1;12;14;1;1;1;1;9;10;11;1;1;1;0;0;1;1;1;0;0;0;0;0;0;0
0;0;0;25;25;0;0;0;0;0;0;12;14;0;0;1;12;14;1;1;1;1;12;22;14;6;1;1;0;0;1;2;1;1;1;1;1;1;0;0
0;1;25;25;25;25;0;0;0;0;0;12;14;0;0;1;15;17;2;7;8;1;15;16;17;7;8;1;0;0;1;1;1;7;8;1;5;1;0;0
0;25;25;26;25;25;26;0;0;0;0;12;14;0;0;1;1;1;1;1;1;1;1;1;1;1;1;1;0;0;7;8;1;1;6;7;8;1;0;0
0;25;25;25;25;25;25;0;0;0;0;12;14;0;0;0;0;0;0;0;0;0;1;1;1;1;1;1;0;0;1;1;7;8;1;1;6;1;0;0
0;25;25;25;25;25;26;0;0;0;0;12;14;0;0;0;0;0;0;0;0;0;0;0;1;1;0;0;0;0;4;1;1;1;1;1;1;1;0;0
0;0;0;25;26;0;0;0;0;1;1;12;14;1;1;1;1;1;0;0;0;0;0;0;1;1;0;0;0;0;0;0;0;1;1;0;0;0;0;0
0;0;0;25;25;0;0;0;0;1;9;18;19;10;10;10;11;1;0;0;0;0;0;0;25;26;0;0;0;0;0;0;0;1;1;0;0;0;0;0
0;0;0;1;1;0;0;0;0;1;12;22;13;13;13;13;14;1;0;0;0;0;0;0;26;25;0;0;0;0;0;0;0;25;26;0;0;0;0;0
0;0;1;1;1;1;0;0;0;1;15;16;16;16;16;16;17;1;0;0;0;0;0;0;25;25;0;0;0;0;0;0;0;25;25;0;0;0;0;0
0;1;1;1;2;1;1;0;0;1;1;1;1;0;0;1;1;3;0;0;0;0;0;0;25;25;0;0;0;0;0;0;25;26;25;25;25;0;0;0
0;7;8;9;11;8;1;0;0;0;1;1;1;0;0;1;1;1;0;0;0;0;1;1;1;1;1;1;1;1;1;1;26;25;25;25;26;0;0;0
0;1;9;18;19;11;1;0;0;0;1;1;1;0;0;1;1;1;0;0;0;0;1;1;9;10;10;11;1;1;1;1;25;25;25;25;25;0;0;0
0;1;15;20;21;17;1;0;0;0;1;1;1;0;0;1;1;1;0;0;0;0;1;1;12;22;13;14;1;1;1;1;25;26;25;26;0;0;0;0
0;7;8;15;17;8;1;1;0;0;1;1;1;0;0;9;10;11;0;0;0;0;7;8;12;13;13;14;8;1;1;1;0;0;0;0;0;0;0;0
0;1;1;1;1;1;1;1;1;0;1;1;1;0;0;12;22;14;0;0;0;0;5;1;15;16;16;17;1;1;1;1;0;0;0;0;0;0;0;0
0;0;0;1;1;1;1;1;1;1;1;1;1;0;1;15;16;17;1;1;0;0;1;1;1;1;1;0;1;1;2;1;1;1;1;1;0;0;0;0
0;0;0;0;1;1;1;1;2;1;1;1;1;1;1;1;1;1;1;1;0;0;1;1;1;1;1;0;1;1;1;0;0;1;1;1;0;0;0;0
0;0;0;0;1;1;1;1;1;1;1;1;1;1;1;1;1;1;1;1;0;0;0;1;1;0;0;0;0;0;0;0;0;1;1;3;0;0;0;0
0;25;25;0;1;7;8;1;1;1;7;8;1;1;1;0;0;0;0;0;0;0;0;1;6;0;0;0;0;0;0;0;0;1;4;1;0;0;0;0
0;25;25;25;1;1;1;9;10;10;11;1;1;1;1;1;1;1;1;1;1;1;1;1;1;0;0;0;0;0;0;0;0;1;1;1;0;0;0;0
0;25;25;25;1;1;1;12;22;13;14;1;1;1;1;1;1;4;1;1;1;1;1;1;1;0;0;0;0;0;0;0;0;0;1;1;0;0;0;0
0;25;25;25;1;1;1;15;16;16;17;1;1;1;1;1;1;9;11;1;1;2;7;8;1;1;0;0;0;0;0;0;0;0;1;1;0;0;0;0
0;0;0;0;1;7;8;1;1;1;7;8;1;1;1;9;10;18;19;10;10;10;10;10;10;10;10;10;10;10;10;10;10;10;10;10;11;1;0;0
0;0;0;0;1;1;1;1;1;4;1;1;1;1;1;15;16;16;16;16;16;16;16;16;16;16;16;16;16;16;16;16;16;16;16;16;17;3;0;0
0;0;0;0;0;0;0;0;0;0;0;0;0;0;0;0;0;0;0;0;0;0;0;0;0;0;0;0;0;0;0;0;0;0;0;0;0;0;0;0

53;53;53;53;53;53;53;53;53;53;53;53;53;53;53;53;53;53;53;53;53;53;53;53;53;53;53;53;53;53;53;53;53;53;53;53;53;53;53;53
53;53;59;3;5;5;5;7;61;53;53;53;59;11;3;7;11;61;53;53;53;53;53;53;53;53;59;5;1;1;11;1;13;75;75;1;1;11;5;61
53;59;42;73;73;73;73;73;41;61;53;59;42;12;4;10;12;41;61;53;53;53;53;53;53;53;60;6;2;9;12;2;14;75;75;2;9;12;6;62
53;60;40;74;74;74;74;74;38;62;53;60;40;0;0;0;0;38;62;53;53;59;11;1;1;11;39;0;0;0;0;0;0;0;0;0;0;0;0;63
53;64;73;73;0;0;0;0;73;63;53;64;0;0;0;0;0;0;63;53;53;60;12;2;9;12;40;0;0;55;54;56;0;0;0;0;0;0;55;67
53;64;74;74;0;0;0;0;74;63;53;64;0;0;0;0;0;0;63;53;53;64;0;0;0;0;0;0;0;57;53;65;54;54;69;1;17;19;52;61
53;64;73;73;73;0;0;73;73;63;53;64;0;25;0;0;25;0;63;53;53;64;0;25;0;0;0;25;0;57;53;53;53;53;60;73;18;20;73;62
59;52;1;1;13;17;19;1;1;51;1;39;0;26;0;0;26;0;37;1;61;64;0;26;0;0;0;26;0;33;3;5;7;61;64;74;0;0;74;63
60;2;6;6;14;18;20;2;6;6;6;40;0;0;0;0;0;0;38;2;62;64;0;0;0;0;0;0;0;34;4;6;8;62;64;0;0;0;0;63
64;0;25;0;0;0;0;0;0;0;0;0;0;0;0;0;0;0;0;0;63;64;0;0;0;0;0;0;0;0;0;0;0;63;64;0;0;0;0;63
64;0;26;0;0;0;0;0;0;0;0;0;0;0;0;0;0;0;0;0;63;64;0;0;0;0;27;29;0;0;0;0;0;63;64;0;0;0;0;63
64;0;0;0;0;0;0;0;0;0;0;0;0;0;0;0;0;0;27;1;51;11;1;13;17;19;42;41;71;54;56;0;55;67;65;54;54;54;54;67
65;54;69;17;19;71;56;0;0;55;69;17;19;71;69;13;17;19;42;73;9;12;2;14;18;20;40;38;62;53;58;0;57;53;53;53;53;53;53;53
53;53;60;18;20;62;65;54;54;67;60;18;20;62;60;14;18;20;40;74;0;0;0;0;0;0;0;0;63;59;35;0;33;1;1;1;1;11;61;53
53;53;64;0;0;63;53;53;53;53;64;0;0;63;64;0;0;0;0;0;0;0;0;0;0;0;0;0;63;60;36;0;34;2;2;2;9;12;62;53
59;5;39;0;0;37;5;61;53;53;64;0;0;63;64;0;0;0;0;0;25;0;0;0;0;0;25;0;63;64;0;0;0;0;25;0;0;0;63;53
60;73;40;0;0;38;73;62;53;53;64;0;0;63;64;0;0;0;0;0;26;0;0;0;0;0;26;0;63;64;0;25;0;0;26;0;25;0;63;53
64;74;0;0;0;0;74;63;53;53;64;0;0;63;64;0;0;0;0;0;0;0;0;0;0;0;0;0;63;64;0;26;0;25;0;0;26;0;63;53
64;0;0;0;0;0;0;63;59;1;52;17;19;51;52;1;11;1;71;54;54;54;56;0;0;0;0;55;67;64;0;0;0;26;0;0;0;0;63;53
64;0;0;0;0;0;0;63;60;73;2;18;20;2;73;9;12;2;62;53;53;53;65;69;17;19;71;67;53;64;0;0;0;0;0;0;0;0;63;53
65;54;69;17;19;71;54;67;64;74;0;0;0;0;74;0;0;0;63;53;53;53;53;60;18;20;62;53;53;65;54;54;69;17;19;71;54;54;67;53
53;53;60;18;20;62;53;53;64;0;0;0;0;0;0;0;0;0;63;53;53;53;53;64;0;0;63;53;53;53;53;53;60;18;20;62;53;53;53;53
59;11;39;0;0;37;11;61;64;0;0;0;0;0;0;0;0;0;63;53;53;53;53;64;0;0;63;53;53;53;53;53;64;0;0;37;1;61;53;53
60;12;40;0;0;38;12;62;64;0;0;0;0;0;0;0;0;0;63;53;53;59;1;52;17;19;51;3;5;7;1;45;39;0;0;38;2;62;53;53
64;0;25;0;0;25;0;63;64;0;0;0;55;54;54;56;0;0;63;53;53;60;2;2;18;20;2;4;73;8;2;46;40;0;0;0;0;63;53;53
64;0;26;0;0;26;0;63;65;54;56;0;57;53;53;58;0;0;63;53;53;64;0;0;0;0;0;0;74;0;0;32;0;0;0;0;0;63;53;53
64;0;0;0;0;0;0;63;53;53;58;0;57;53;59;35;0;0;63;53;53;64;0;0;0;0;0;0;0;0;0;21;0;0;0;0;0;63;53;53
64;0;25;0;0;25;0;37;1;61;58;0;57;53;60;36;0;0;63;53;53;64;0;25;0;0;0;0;25;0;0;22;0;0;0;55;54;67;53;53
64;0;26;0;0;26;0;38;73;62;58;0;57;53;64;0;0;0;63;53;53;64;0;26;0;0;0;0;26;0;0;33;1;1;11;51;61;53;53;53
64;0;0;0;0;0;0;0;74;37;35;0;33;1;39;0;0;0;37;1;61;64;0;0;0;0;0;0;0;0;0;34;2;9;12;2;62;53;53;53
65;54;54;56;0;0;0;0;0;38;36;0;34;2;40;0;0;0;38;6;62;64;0;0;0;0;55;54;56;0;0;0;0;0;0;0;63;53;53;53
59;1;61;65;56;0;0;0;0;0;0;0;0;0;0;0;0;0;0;0;63;65;56;0;0;0;57;53;58;0;55;54;54;56;0;0;63;53;53;53
60;73;41;1;44;0;25;0;0;0;0;25;0;0;0;0;0;0;0;0;63;59;13;17;19;71;67;53;65;54;67;53;53;58;0;0;63;53;53;53
64;74;38;2;30;0;26;0;0;0;0;26;0;0;27;1;3;5;5;7;51;42;14;18;20;62;53;53;53;53;53;53;53;58;0;0;63;53;53;53
64;0;0;0;23;0;0;0;0;0;0;0;0;0;28;6;4;73;73;8;6;40;0;0;0;63;53;53;53;53;53;53;53;58;0;0;63;53;53;53
64;0;0;0;24;0;0;0;0;0;0;0;0;27;39;0;0;74;74;0;0;0;0;25;0;37;1;3;5;5;7;1;11;13;17;19;1;11;61;53
65;56;0;0;31;0;25;0;0;0;0;25;0;28;40;0;0;0;0;0;0;0;0;26;0;38;2;4;73;73;8;9;12;14;18;20;9;12;62;53
53;65;54;69;35;0;26;0;0;0;0;26;0;21;0;0;0;0;0;0;0;0;0;0;0;0;0;0;74;74;0;0;0;0;0;0;0;0;63;53
53;53;53;60;36;0;0;0;0;0;0;0;0;22;0;0;0;0;0;0;0;0;0;0;0;0;0;0;0;0;0;0;0;0;0;0;0;0;63;53
53;53;53;65;54;54;54;54;54;54;54;54;54;66;54;54;54;54;54;54;54;54;54;54;54;54;54;54;54;54;54;54;54;54;54;54;54;54;67;53
