53;53;53;53;53;53;53;53;53;53;53;53;53;53;53;53;53;53;53;53;53;53;53;53;53;53;53;53;53;53;53;53;53;53;53;53;53;53;53;53
53;53;59;3;5;5;5;7;61;53;53;53;59;11;3;7;11;61;53;53;53;53;53;53;53;53;59;5;1;1;11;1;13;75;75;1;1;11;5;61
53;59;42;73;73;73;73;73;41;61;53;59;42;12;4;10;12;41;61;53;53;53;53;53;53;53;60;6;2;9;12;2;14;75;75;2;9;12;6;62
53;60;40;74;74;74;74;74;38;62;53;60;40;0;0;0;0;38;62;53;53;59;11;1;1;11;39;0;0;0;0;0;0;0;0;0;0;0;0;63
53;64;73;73;0;0;0;0;73;63;53;64;0;0;0;0;0;0;63;53;53;60;12;2;9;12;40;0;0;55;54;56;0;0;0;0;0;0;55;67
53;64;74;74;0;0;0;0;74;63;53;64;0;0;0;0;0;0;63;53;53;64;0;0;0;0;0;0;0;57;53;65;54;54;69;1;17;19;52;61
53;64;73;73;73;0;0;73;73;63;53;64;0;25;0;0;25;0;63;53;53;64;0;25;0;0;0;25;0;57;53;53;53;53;60;73;18;20;73;62
59;52;1;1;13;17;19;1;1;51;1;39;0;26;0;0;26;0;37;1;61;64;0;26;0;0;0;26;0;33;3;5;7;61;64;74;0;0;74;63
60;2;6;6;14;18;20;2;6;6;6;40;0;0;0;0;0;0;38;2;62;64;0;0;0;0;0;0;0;34;4;6;8;62;64;0;0;0;0;63
64;0;25;0;0;0;0;0;0;0;0;0;0;0;0;0;0;0;0;0;63;64;0;0;0;0;0;0;0;0;0;0;0;63;64;0;0;0;0;63
64;0;26;0;0;0;0;0;0;0;0;0;0;0;0;0;0;0;0;0;63;64;0;0;0;0;27;29;0;0;0;0;0;63;64;0;0;0;0;63
64;0;0;0;0;0;0;0;0;0;0;0;0;0;0;0;0;0;27;1;51;11;1;13;17;19;42;41;71;54;56;0;55;67;65;54;54;54;54;67
65;54;69;17;19;71;56;0;0;55;69;17;19;71;69;13;17;19;42;73;9;12;2;14;18;20;40;38;62;53;58;0;57;53;53;53;53;53;53;53
53;53;60;18;20;62;65;54;54;67;60;18;20;62;60;14;18;20;40;74;0;0;0;0;0;0;0;0;63;59;35;0;33;1;1;1;1;11;61;53
53;53;64;0;0;63;53;53;53;53;64;0;0;63;64;0;0;0;0;0;0;0;0;0;0;0;0;0;63;60;36;0;34;2;2;2;9;12;62;53
59;5;39;0;0;37;5;61;53;53;64;0;0;63;64;0;0;0;0;0;25;0;0;0;0;0;25;0;63;64;0;0;0;0;25;0;0;0;63;53
60;73;40;0;0;38;73;62;53;53;64;0;0;63;64;0;0;0;0;0;26;0;0;0;0;0;26;0;63;64;0;25;0;0;26;0;25;0;63;53
64;74;0;0;0;0;74;63;53;53;64;0;0;63;64;0;0;0;0;0;0;0;0;0;0;0;0;0;63;64;0;26;0;25;0;0;26;0;63;53
64;0;0;0;0;0;0;63;59;1;52;17;19;51;52;1;11;1;71;54;54;54;56;0;0;0;0;55;67;64;0;0;0;26;0;0;0;0;63;53
64;0;0;0;0;0;0;63;60;73;2;18;20;2;73;9;12;2;62;53;53;53;65;69;17;19;71;67;53;64;0;0;0;0;0;0;0;0;63;53
65;54;69;17;19;71;54;67;64;74;0;0;0;0;74;0;0;0;63;53;53;53;53;60;18;20;62;53;53;65;54;54;69;17;19;71;54;54;67;53
53;53;60;18;20;62;53;53;64;0;0;0;0;0;0;0;0;0;63;53;53;53;53;64;0;0;63;53;53;53;53;53;60;18;20;62;53;53;53;53
59;11;39;0;0;37;11;61;64;0;0;0;0;0;0;0;0;0;63;53;53;53;53;64;0;0;63;53;53;53;53;53;64;0;0;37;1;61;53;53
60;12;40;0;0;38;12;62;64;0;0;0;0;0;0;0;0;0;63;53;53;59;1;52;17;19;51;3;5;7;1;45;39;0;0;38;2;62;53;53
64;0;25;0;0;25;0;63;64;0;0;0;55;54;54;56;0;0;63;53;53;60;2;2;18;20;2;4;73;8;2;46;40;0;0;0;0;63;53;53
64;0;26;0;0;26;0;63;65;54;56;0;57;53;53;58;0;0;63;53;53;64;0;0;0;0;0;0;74;0;0;32;0;0;0;0;0;63;53;53
64;0;0;0;0;0;0;63;53;53;58;0;57;53;59;35;0;0;63;53;53;64;0;0;0;0;0;0;0;0;0;21;0;0;0;0;0;63;53;53
64;0;25;0;0;25;0;37;1;61;58;0;57;53;60;36;0;0;63;53;53;64;0;25;0;0;0;0;25;0;0;22;0;0;0;55;54;67;53;53
64;0;26;0;0;26;0;38;73;62;58;0;57;53;64;0;0;0;63;53;53;64;0;26;0;0;0;0;26;0;0;33;1;1;11;51;61;53;53;53
64;0;0;0;0;0;0;0;74;37;35;0;33;1;39;0;0;0;37;1;61;64;0;0;0;0;0;0;0;0;0;34;2;9;12;2;62;53;53;53
65;54;54;56;0;0;0;0;0;38;36;0;34;2;40;0;0;0;38;6;62;64;0;0;0;0;55;54;56;0;0;0;0;0;0;0;63;53;53;53
59;1;61;65;56;0;0;0;0;0;0;0;0;0;0;0;0;0;0;0;63;65;56;0;0;0;57;53;58;0;55;54;54;56;0;0;63;53;53;53
60;73;41;1;44;0;25;0;0;0;0;25;0;0;0;0;0;0;0;0;63;59;13;17;19;71;67;53;65;54;67;53;53;58;0;0;63;53;53;53
64;74;38;2;30;0;26;0;0;0;0;26;0;0;27;1;3;5;5;7;51;42;14;18;20;62;53;53;53;53;53;53;53;58;0;0;63;53;53;53
64;0;0;0;23;0;0;0;0;0;0;0;0;0;28;6;4;73;73;8;6;40;0;0;0;63;53;53;53;53;53;53;53;58;0;0;63;53;53;53
64;0;0;0;24;0;0;0;0;0;0;0;0;27;39;0;0;74;74;0;0;0;0;25;0;37;1;3;5;5;7;1;11;13;17;19;1;11;61;53
65;56;0;0;31;0;25;0;0;0;0;25;0;28;40;0;0;0;0;0;0;0;0;26;0;38;2;4;73;73;8;9;12;14;18;20;9;12;62;53
53;65;54;69;35;0;26;0;0;0;0;26;0;21;0;0;0;0;0;0;0;0;0;0;0;0;0;0;74;74;0;0;0;0;0;0;0;0;63;53
53;53;53;60;36;0;0;0;0;0;0;0;0;22;0;0;0;0;0;0;0;0;0;0;0;0;0;0;0;0;0;0;0;0;0;0;0;0;63;53
53;53;53;65;54;54;54;54;54;54;54;54;54;66;54;54;54;54;54;54;54;54;54;54;54;54;54;54;54;54;54;54;54;54;54;54;54;54;67;53
