11 9 3 5 7 9 9 3 5 7 9 13 0 0 0 0
12 10 4 6 8 10 10 4 6 8 10 14 0 0 0 0 
15 0 0 0 0 0 0 0 0 0 0 16 0 0 0 0
15 0 21 0 0 0 0 0 0 0 0 16 0 0 0 0
15 0 22 0 0 0 0 0 0 0 0 16 0 0 0 0
17 1 1 9 1 1 1 1 9 1 1 19 0 0 0 0
18 2 2 10 2 2 2 2 10 2 2 20 0 0 0 0
0 0 0 0 0 0 0 0 0 0 0 0 0 0 0 0
0 0 0 0 0 0 0 0 0 0 0 0 0 0 0 0
0 0 0 0 0 0 0 0 0 0 0 0 0 0 0 0
0 0 0 0 0 0 0 0 0 0 0 0 0 0 0 0
0 0 0 0 0 0 0 0 0 0 0 0 0 0 0 0